{
  "width": 10,
  "height": 8,
  "tiles": [
    [1,1,1,1,1,1,1,1,1,1],
    [1,0,0,0,0,5,0,0,0,1],
    [1,3,2,2,2,2,2,4,0,1],
    [1,0,0,0,5,0,0,0,0,1],
    [1,0,0,0,0,0,0,0,0,1],
    [1,0,0,0,0,0,0,0,0,1],
    [1,0,0,0,0,0,0,0,0,1],
    [1,1,1,1,1,1,1,1,1,1]
  ]
}


